10
6667776665
8867975640
8055775455
6540521104
6044137714
6511429971
5114429754
3770277544
2552455404
4244244444
